R 1280 720

NO ./images/fractal1.xpm
SO ./images/fractal2.xpm
WE ./images/fractal3.xpm
EA ./images/fractal4.xpm

S ./textures/128x128/assets/minecraft/textures/items/apple_golden.xpm

F 88,41,0
C 37,253,233

        1111111111111111111111111
        1000000000110000000000001
        1011000001110000002000001
        10010020000000000000000011
11111111101100000111000000000000W1
1000000000110000011101111111111111
111121111111110111000000100011111
11110111111111011101010010001
11000000110101011100000010001
10002000000000001100000010001
10000000000000001101010010001
1100000111010101111101111000111
11110111 1110101 101111010001
11111111 1111111 111111111111
