R 1280 720

NO ./images/fractal1.xpm
SO ./images/fractal2.xpm
WE ./images/fractal3.xpm
EA ./images/fractal4.xpm

S ./images/end_crystal.xpm

F 100,100,100
C 37,25,233

        1111111111111111111111111
        1000000000110000000000001
        10110000011100000000000W1
        10010000000000000000000011
1111111110110000011100000000000001
1000000000110000011101111111111111
111101111111110111000000100011111
11110111111111011101010010001
11000000110101011100000010001
10000000000000001100000010001
10000000000000001101010010001
1100000111010101111101111000111
11110111 1110101 101111010001
11111111 1111111 111111111111
