R 1180 710

NO ./images/grass.xpm
SO ./images/cobblestone.xpm
WE ./images/diamond_ore.xpm
EA ./images/diamond_block.xpm

S ./images/end_crystal.xpm
F 88,11,0
C 17,151,111

111111111111111111111111
100000000000000000000001
100000000000000000000001
100000000000000000000001
100000111110000101010001
100000100010000000000001
100000100010000100010001
100000100010000000000001
100000110110000101010001
100000000000000000000001
10000000N000000000000001
100000000000000000000001
100000000000000002000001
100000000000000002000001
100000000000000002000001
100000000000000002000001
111111111000000002000001
110100001000000002000001
110000201000000000000001
110100001000000000000001
110111111000000000000001
110000000000000000000001
111111111000000000000001
111111111111111111111111
